111111111111111111111111
100100000101100100000101
110001N10000010001010001
100100000001100100000001
100100000101100100000101
100100000000000100000001
100100000001100100000001
100100000001100100000001
111111111111111111111111