1111111
10S1001
1000001
1000001
1100111
1111111