111111111111
100100000101
110001010001
100100000101
100000000001
100100000001
100100N00101
111111111111