111111111111
100100000101
110001N10001
100100000001
100100000101
111111111111