111111111111111111111111
100100000101100100000101
110001010000010001010001
100100000001100100000001
100000000101100100000101
10010000000000000000W001
100100000001100000000001
100100000001100100000001
111111111111111111111111