1111111
1000001
10S0011
1000001
1000001
1100111
1111111