11111111111111111111111111111
10000000001100000000000000001
10110000011100000000000000001
10010000000000000000000000001
111111111011N0000111000000001
10000000001100000111011111111
11110111111111011100000010001
11110111111111011101010010001
11000000110101011100000010001
10000000000000001100000010001
10000000000000001101010010001
11000001110101011111011110001
11110111111101011101111010001
11111111111111111111111111111